Beyond - Alem / Fora
Waste - Desperdicio / Residuos
Cocky - Abusado
Arise - Surgem
pledge - juramento, promessa, testemunho
stuff  - coisa
already - ja
regret - lamento, Arrependo
tear - lagrima
closely - intimamente
tough - pesado, duro
wild - selvagem, natureza
matter - importar
disease - doen√ßas, problemas de saude
throat - pescoco
pleasure - prazer
blanked - cobertor
wet - molhado
nephew - sobrinho
Threat - ameaca
increase - aumentar
jealous - ciumento
thorough - minusioso
mad - brava, raiva
shallow - rasas
lack - falta, carencia
suddenly - de repente
shy - timida
wise - esperto
become - se tornando
candle -vela
instead - em vez disso
sppeches - Discurso
doves - Pombos
advice - conselho
dork - idiota
heavy - pesado/ forte/ dificil
worried - preocupar
budget - orcamento
hire - contratar
afraid - medo
warehouse - deposito/ armazem
uncle - tio
thrill - emocao
imply - sugerir
God forbid - Deus o livre
step - pisar
several - varias